Basic
Level = "Level"
Level (Short) = "LV"
HP = "Health"
HP (Short) = "♥"
MP = "Stored Essence"
MP (Short) = "◘"
TP = "Power"
TP (Short) = "♠"

Params
Maximum HP = "MaxHP"
Maximum MP = "MaxMP"
Attack Power = "ATK"
Defense = "DEF"
Magic Power = "MAT"
Magic Defense = "MDF"
Agility = "AGI"
Luck = "LUK"

ETypes
Weapon = "Weapon"
Shield = "Shield"
Head = "Headgear"
Body = "Bodygear"
Ornaments = "Accessory"

Commands
Fight = "Fight"
Escape = "Escape"
Attack = "Attack"
Defend = "Guard"
Item = "Items"
Skill = "Skills"
Equipment = "Equipment"
Status = "Status"
Sorting = ""
Save = "Save"
End of Game = "Game End"
(Missing Number) = ""
Weapons = "Weapons"
Armor = "Armours"
Valuables = "Key Items"
Change Equipment = "Change"
Best Equipment = "Optimize"
Remove All = "Clear"
New Game = "New Game"
Continue = "Load Game"
Shutdown = "Quit Game"
Go to Title = "To Title"
Quit = "Cancel"
